###################F#######
#     #        ##    #  # #
##### # #######  ### # #  #
#          #    #  # # # ##
# #### ###   #   # #      #
# #  #   ##### #   #### ###
#  #   # # ##  # ##   #  ##
##  # # #   # #  ## #  #  #
# # #   # # #  #  #  # #  #
S # ##### # ## ## ####    #
#         #   #        #  #
###########################