#################F#
#                 #
######### #########
#       #       # #
####### ####### # #
#   # #         # #
### # ### ### # # #
#       #   # #   #
# ##### ### #######
# #               #
#S#################