######F##########
######      #   #
######### # #####
#           #   #
###### ##########
#    #     #    #
######## # ######
#        #      #
###############S#