#############F#####################
# #        ## ###       #   #     #
# # ### ##      # #####   #   # # #
# # # ########### #################
# # #           #               # #
# # ########### ############### # #
#                               # #
############### ################# #
#                                 #
####### ####### ###################
#     #       #     ####  #####   #
##### ####### #####      #    # ###
#     #           ######## ## # # #
# # # # ##### ###        # ## # # #
# # # # #     # ########## #### # #
# # #   #######                 # #
# # #####     ############ ###### #
# #       # #                     #
###########S#######################