##############################################################################################
# #  # #          #   #  ###   #     ## #   # # # #  ### #     # ###   #  # #    # #    #  # #
#  #     ## # # #  # #  # # # # # ###     ##       #  #   # ##    #  ##  #   # #     ##  #   #
##  # # #    #  ##    #   #   #       ###  ## # ## # # # #  #  # # #    #  #  #  # ##  # # # #
# #  # # ## ## #  # ##  #####   # # ##   ## ##  # #  # #   # ## #    # # ##  #  # # # # #   ##
# ##       #  ## ##    #  #  ##  ### # #  #    #   # # # #        # # #    #  #     # #  # # #
#  # # # #   ##     # #  # #  # # #     # # ##   ##      ### # ##  #   # ### #  # ##  # #  # #
# # # ### # ## ## #  #  ##  #      # ##  #    ### # # ##    ##  ###  #         # ## #    #   #
# # #  #    #  ###  ###   #  ## ###    ## ## ##      #   ##   #     # # # ## #        ##   # #
S   # #  ##  #  # # ### ##  # # #   ## #        # # #  ##   ##### #    ##   #  # ## #   # #  #
###    # # #  #      #  # #       # # # # # # #### # ##  # #  #  ## ## # ## # #   #  # # # # #
# ### # #   #   ## #  #    # ####  #    # ## #  #  #    # #  #  #  #   #  #  # # ## #      # #
#       ###  ###  #  ## # #      #   ##        # #   # #    #  ## # ## ##  # #  ## # # # #  ##
# # # #   # #    # # # ##   ## # ## #   # ### #   # # #  # # #       ##   # #  ##     #   #  #
#  ## # #     ##          #  # #   ### #     # # #     # #     # # #    #     #   ## # ##  ###
## # # # # # #   # # # #### #   # ###   # ####     # #    # # # # # ###  # ##  ## # ##   #   #
# #         # ###  ##      # ##  # # # ##      # # #  # ## #           # #   ## # #    #  ####
# # # ## # #      #  # # #   #  #     #  # ### # ## ##      ### # # ## # # #        # ### #  #
#    ####  # # # # #    ### # #  # # ## #     #       # # ##   # #   ## ##  ## # ##  # # ## ##
# ## ### # ##  ##    # # ##    ## #      ## ## # # ##  #  # # #   # #   # #   #    #         #
# #   #   #   #  ## #      # #  #  # ### ##    ## ### # #      # # ## #   # # # ## ## ## # # #
# ### # #  # ###     # # ##  # ## #    #   ###     #     # # #        ###  # #  # #  # #  # ##
##     # #    #  # # #  ##  ##      # ## #    # # #  ## # ##  ###### #  # #   # #   #   #    #
# ## ##    # #  #   #  #  # #  # # #    #  # #   # #  #     #       #  #    #  ## ### ## # # #
#    # # # ## ##  ##  # # ##  # # # # ## #  ### ## # #  # #  # ## #  # # # # #           ## ##
# # ##  # #      ## #      ##       #     #  #  #   # #  ###  #    #    # #   # # # # ##     #
#  #   ##  # ## #     # # #   ## # #  ## # ## #  ##   # ###  # # #  # #     ##  ## # #  # # ##
# #  #    # ##  # ###  #   ##   # #  #         #    ###  #  ## ##  #   # ###  ## # # ## # ####
## #  # # #    #     # # #  # # # # # ## # ## #  ##    #  #      # ## #      #           #  ##
#    #  #   # #  ## #   ### # #    ##  ##   #  #  # ## # #  # ## #  # ## # #   ## # ### ## # #
# ## ## ## #   # ##  ##  # #  # ##    #  # ###  ## ## # # #  # #  # #   ## # # #  ##  # #    #
##     #  #  ## #   #  #   # ##   # #   # # #  #   #       ##   ##  # # #  ##   #    # #  # ##
##### # # # ###   # ## ## ###  # #  # #      #   #   ## # ##  ## ##  #   #   ##  # # #   # ###
##   ##      #  ##      #  # #  # #  # # # ##  # # #  #  #  #     # # # ### # # #  #   #    ##
#  # # ## # #  #  # # # ##     #   # # ###   #  #   ## ## # # ## #    #  #    ## #  ## # ##  #
# #       #  #  #    #   # ## #  #        ##  # # #             ### # # #  ##     #  # # #  ##
#################################################F############################################
